fhw lbfb@kpom.jfdkatb schrieb: ich!^Ich bin weiblich! wirklich!
sequior femininus malus et/aut prior prime masculus
feme			feme
femi			Frauen
femin			eine Frau
feminin			weiblich
femininus		weibisch
male			krank
malus			schlecht
mas			der männliche
mask			Maske
masc			wählten
mascu			gehörte zu
mascul			Männchen
masculus		männlich
prim			erste
prima			erste
primarius		ausgezeichnet
primas			der Erste, Oberste, geistl. Fürst
prime			vorzüglich
primo			anfangs, zu erst
primus			erste, vorderste, vormehmste, haupt-, ursprünglich
primor			MAIN
primior			davon	
primaer			die erste
pi			Pi
pio			fromm
pior			näher
prio			die alten
prior			erste
se			er
seq			folgende
sequ			zu folgen
sequio			folgt
sequior			folgt
sequo			ich folge
sequor			folgen, nachgehen
secus			durch
sexus			Sex, Geschlecht
secus sequor 		anders, weniger gut, schlechter